%%%%%%%%%%%%%%%%%%%%%%%%%%%%%%%%%%%%%%%%%%%%%%%%%%%%%
%%%%%%%%%%%%%%%%%%%%%%%%%%%%%%%%%%%%%%%%%%%%%%%%%%%%%
%%%%%%                                         %%%%%%
%%%%%%                                         %%%%%%
%%%%%%                                         %%%%%%
%%%%%%                                         %%%%%%
%%%%%%                                         %%%%%%
%%%%%%                                         %%%%%%
%%%%%%                                         %%%%%%
%%%%%%                                         %%%%%%
%%%%%%                                         %%%%%%
%%%%%%                                         %%%%%%
%%%%%%                                         %%%%%%
%%%%%%                                         %%%%%%
%%%%%%                                         %%%%%%
%%%%%%                                         %%%%%%
%%%%%%                                         %%%%%%
%%%%%%                                         %%%%%%
%%%%%%                                         %%%%%%
%%%%%%                                         %%%%%%
%%%%%%                                         %%%%%%
%%%%%%                                         %%%%%%
%%%%%%           ...........                   %%%%%%
%%%%%%           ...........                   %%%%%%
%%%%%%           ...........                   %%%%%%
%%%%%%                                         %%%%%%
%%%%%%                                         %%%%%%
%%%%%%                                         %%%%%%
%%%%%%                                         %%%%%%
%%%%%%                                         %%%%%%
%%%%%%                                         %%%%%%
%%%%%%                                         %%%%%%
%%%%%%                                         %%%%%%
%%%%%%                                         %%%%%%
%%%%%%          .........                      %%%%%%
%%%%%%         ...........                     %%%%%%
%%%%%%        .............                    %%%%%%
%%%%%%         ...........                     %%%%%%
%%%%%%          .........                      %%%%%%
%%%%%%                                         %%%%%%
%%%%%%                                         %%%%%%
%%%%%%%%%%%%%%%%%%%%%%%%%%%%%%%%%%%%%%%%%%%%%%%%%%%%%
%%%%%%%%%%%%%%%%%%%%%%%%%%%%%%%%%%%%%%%%%%%%%%%%%%%%%
#
%%%%%%%%%%%%%%%%%%%%%%%%%%%%%%%%%%%%%%%%%%%%%%%%%%%%%
%%%%%%%%%%%%%%%%%%%%%%%%%%%%%%%%%%%%%%%%%%%%%%%%%%%%%
%%%%%%%%%%%%%%%%%%%%%%%%%%%%%%%%%%%%%%%%%%%%%%%%%%%%%
%%%%%%%%%%%%%%%%%%%%%%%%%%%%%%%%%%%%%%%%%%%%%%%%%%%%%
%%%%%%%%%%%%%%%%%%%%%%%%%%%%%%%%%%%%%%%%%%%%%%%  %%%%
%%%%%%%%%%%%%%%%%%%%%%%%%%%%%%%%%%%%%%%%%%%%%%%% %%%%
%%%%%%%%P           %%%%%%%%%%%%%%%%%%%%%%%%%%%% %%%%
%%%%%%%%             %%%%%%%%%%%%%%%%%%%%%%%%%%% %%%%
%%%%%%%%%%%%%%%%%%%%%%%%%%%%%%%%%%%%%%%%%%%%%%%%%%%%%
%%%%%%%%%%%%%%%%%%%%%%%%%%%%%%%%%%%%%%%%%%%%%%%%%%%%%
%%%%%%%%%%%%%%%%%%%%%%%%%%%%%%%%%%%%%%     %%%%%%%%%%
%%%%%%%%%%%%%%%%%%%%%%%%%%%%%%%%%%%%%%%    %%%%%%%%%%
%%%%%%%%%%%%%%%%%%%%%%%%%%%%%%%%%%%%%%%    %%%%%%%%%%
%%%%%%%%%%%%%%%%%%%%%%%%%%%%%%%%%%%%%%%%    %%%%%%%%%
%%%%%%%%%%%%%%%%%%%%%%           %%%%%%%    %%%%%%%%%
%%%%                             %%%%%%%%   %%%%%%%%%
%%%%                              %%%%%%%    %%%%%%%%
%%%%                              %%%%%%%%   %%%%%%%%
%%%%                               %%%%%%%    %%%%%%%
%%%%     %%%%%%%%%%%%%%%%%%%%%%%%%%%%%%%%%%   %%%%%%%
%%%%    %%%%%%%%%%%%%%%%%%%%%%%%%%%%%%%%%%%   %%%%%%%
%%%%   %%%%%%%%%%%%%%%%%%%%%%%%%%%%%%%%%%%%%   %%%%%%
%%%%   %%%%%%%%%%%%%%%%%%%%%%%%%%%%%%%%%%%%%   %%%%%%
%%%%   %%%%%%%%%%%%%%%%%%%%%%%%%%%%%%%%%%%%%   %%%%%%
%%%%   %%%%%%%%%%%%%%%%%%%%%%%%%%%%%%%%%%%%%   %%%%%%
%%%%   %%%%%%%%%%%%%%%%%%%%%%%%%%%%%%%%%%%%%   %%%%%%
%%%%    %%%%%%%%%%%%%%%%%%%%%%%%%%%%%%%%%%%%  %%%%%%%
%%%%     %%%%%%%%%%%%%%%%%%%%%%%%%%%%%%%%%%% %%%%%%%%
%%%%              %%%%%%%%%%%%%%%%%%%%%%%%%%%%%%%%%%%
%%%%             %%%%%%%%%%%%%%%%%%%%%%%%%%%%%%%%%%%%
%%%%            %%%%%%%%%%%%%%%%%%%%%%%%%%%%%%%%%%%%%
%%%%           %%%%%%%%%%%%%%%%%%%%%%%%%%%%%%%%%%%%%%
%%%%          %%%%%%%%%%%%%%%%%%%%%%%%%%%%%%%%%%%%%%%
%%%%         %%%%%%%%%%%%%%%%%%%%%%%%%%%%%%%%%%% %%%%
%%%%        %%%%%%%%%.%%%%%%%            %%%%%%% %%%%
%%%%       %%%%%%%%%..%%%%%%%            %%%%%%% %%%%
%%%%      %%%%%%%%%...%%%%%%%            %%%%%%% %%%%
%%%%     %%%%%%%%%%%%%%%%%%%%%%%%%%%%%%%%%%%%%%% %%%%
%%%%    %%%%%%%%%%%%%%%%%%%%%%%%%%%%%%%%%%%%%%%% %%%%
%%%%%%%%%%%%%%%%%%%%%%%%%%%%%%%%%%%%%%%%%%%%%%%%%%%%%
%%%%%%%%%%%%%%%%%%%%%%%%%%%%%%%%%%%%%%%%%%%%%%%%%%%%%
%%%%%%%%%%%%%%%%%%%%%%%%%%%%%%%%%%%%%%%%%%%%%%%%%%%%%
%%%%%%%%%%%%%%%%%%%%%%%%%%%%%%%%%%%%%%%%%%%%%%%%%%%%%
#
%%%%%%%%%%%%%%%%%%%%%%%%%%%%%%%%%%%%%%%%%%%%%%%%%%%%%
%%%%%%%%%%%%%%%%%%%%%%%%%%%%%%%%%%%%%%%%%%%%%%%%%%%%%
%%%%%%%%%%%%%%%%%%%%%%%%%%%%%%%%%%%%%%%%%%%%%%%%%%%%%
%%%%%%%%%%%%%%%%%%%%%%%%%%%%%%%%%%%%%%%%%%%%%%%%%%%%%
%%%%%%%%%%%%%%%%%%%%%%%%%%%%%%%%%%%%%%%%%%%%%%%%%%%%%
%%%%%%%%%%%%%%%%%%%%%%%%%%%%%%%%%%%%%%%%%%%%%%%%%%%%%
%% %%%%%%%%%%%%%%%%%%%                             %%
%% %%%%%%%%%%%%%%%%%%%                             %%
%% %%%%%%%%%%%%%%%%%%%                             %%
%% %%%%%%%%%%%%%%%%%%%                             %%
%% %%%%%%%%%%%%%%%%%%%                             %%
%% %%%%%%%%%%%%%%%%%%%                             %%
%% %%%%%%%%%%%%%%%%%%%                             %%
%% %%%%%%%%%%%%%%%%%%%                             %%
%% %%%%%%%%%%%%%%%%%%%                             %%
%% %%%%%%%%%%%%%%%%%%%                             %%
%% %%%%%%%%%%%%%%%%%%%                             %%
%%                                                 %%
%%                   ...                           %%
%%                   ...                           %%
%%                   ...                           %%
%%                   ...                           %%
%%                   ...                           %%
%%                   ...                           %%
%%                   ...                           %%
%%                   ...                           %%
%%                   ...                           %%
%%                   ...                           %%
%%                   ...                           %%
%%                                                 %%
%%                  .                              %%
%%                 ...                             %%
%%                .....                            %%
%%                .....                            %%
%%                .....                            %%
%%                .....                            %%
%%                .....                            %%
%%%%%%%%%%%%%%%%%%%%%%%%%%%%%%%%%%%%%%%%%%%%%%%%%%%%%
%%%%%%%%%%%%%%%%%%%%%%%%%%%%%%%%%%%%%%%%%%%%%%%%%%%%%
%%%%%%%%%%%%%%%%%%%%%%%%%%%%%%%%%%%%%%%%%%%%%%%%%%%%%
%%%%%%%%%%%%%%%%%%%%%%%%%%%%%%%%%%%%%%%%%%%%%%%%%%%%%
%%%%%%%%%%%%%%%%%%%%%%%%%%%%%%%%%%%%%%%%%%%%%%%%%%%%%
%%%%%%%%%%%%%%%%%%%%%%%%%%%%%%%%%%%%%%%%%%%%%%%%%%%%%
#
