%%%%%%%%%%%%%%%%%%%%%%%%%%%%%%%%%
%%%%%%%%%%%%%%%%%%%%%%%%%%%%%%%%%
%%%%                         %%%%
%%%%                         %%%%
%%%%                         %%%%
%%%%                         %%%%
%%%%                         %%%%
%%%%                         %%%%
%%%%                         %%%%
%%%%                         %%%%
%%%%                         %%%%
%%%%                         %%%%
%%%%                         %%%%
%%%%                         %%%%
%%%%       .......           %%%%
%%%%       .......           %%%%
%%%%                         %%%%
%%%%                         %%%%
%%%%                         %%%%
%%%%                         %%%%
%%%%                         %%%%
%%%%                         %%%%
%%%%     ........            %%%%
%%%%     ........            %%%%
%%%%                         %%%%
%%%%%%%%%%%%%%%%%%%%%%%%%%%%%%%%%
%%%%%%%%%%%%%%%%%%%%%%%%%%%%%%%%%
#
%%%%%%%%%%%%%%%%%%%%%%%%%%%%%%%%%
%%%%%%%%%%%%%%%%%%%%%%%%%%%%%%%%%
%%%%%%%%%%%%%%%%%%%%%%%%%%%%%%%%%
%%%%%P%%%%%%%%%%%%%%%%%%%%%%%% %%
%%%%%        %%%%%%%%%%%%%%%%%%%%
%%%%%%%%%%%%%%%%%%%%%%%%%%%%%%%%%
%%%%%%%%%%%%%%%%%%%%%%%%%%%%%%%%%
%%%%%%%%%%%%%%%%%%%%%%%%%  %%%%%%
%%%%%%%%%%%%%%%%%%%%%%%%%  %%%%%%
%%%%%%%%%%%%%%       %%%%%  %%%%%
%%%                  %%%%%  %%%%%
%%%                   %%%%% %%%%%
%%%  %%%%%%%%%%%%%%%%%%%%%%  %%%%
%%%  %%%%%%%%%%%%%%%%%%%%%%% %%%%
%%% %%%%%%%%%%%%%%%%%%%%%%%% %%%%
%%% %%%%%%%%%%%%%%%%%%%%%%%% %%%%
%%%  %%%%%%%%%%%%%%%%%%%%%%% %%%%
%%%   %%%%%%%%%%%%%%%%%%%%%%%%%%%
%%%        %%%%%%%%%%%%%%%%%%%%%%
%%%       %%%%%%%%%%%%%%%%%%%%%%%
%%%      %%%%%%%%%%%%%%%%%%%%%%%%
%%%     %%%%%%%%%%%%%%%%%%%%%% %%
%%%    %%%%%%.%%%%        %%%% %%
%%%   %%%%%%%%%%%%%%%%%%%%%%%% %%
%%%%%%%%%%%%%%%%%%%%%%%%%%%%%%%%%
%%%%%%%%%%%%%%%%%%%%%%%%%%%%%%%%%
%%%%%%%%%%%%%%%%%%%%%%%%%%%%%%%%%
#
%%%%%%%%%%%%%%%%%%%%%%%%%%%%%%%%%
%%%%%%%%%%%%%%%%%%%%%%%%%%%%%%%%%
%%%%%%%%%%%%%%%%%%%%%%%%%%%%%%%%%
%%%%%%%%%%%%%%%%%%%%%%%%%%%%%%%%%
%%%%%%%%%%%%%%                  %
%%%%%%%%%%%%%%                  %
%%%%%%%%%%%%%%                  %
%%%%%%%%%%%%%%                  %
%%%%%%%%%%%%%%                  %
%%%%%%%%%%%%%%                  %
%%%%%%%%%%%%%%                  %
%%            .                 %
%%           ..                 %
%%           ..                 %
%%           ..                 %
%%           ..                 %
%%           ..                 %
%%           ..                 %
%%                              %
%%          ..                  %
%%          ..                  %
%%          ..                  %
%%          ..                  %
%%%%%%%%%%%%%%%%%%%%%%%%%%%%%%%%%
%%%%%%%%%%%%%%%%%%%%%%%%%%%%%%%%%
%%%%%%%%%%%%%%%%%%%%%%%%%%%%%%%%%
%%%%%%%%%%%%%%%%%%%%%%%%%%%%%%%%%
#
