%%%%%%%%%%%%%%%%%%%%%%%%%%%
%%%%%%%%%%%%%%%%%%%%%%%%%%%
%%%%                   %%%%
%%%%                   %%%%
%%%%                   %%%%
%%%%                   %%%%
%%%%                   %%%%
%%%%                   %%%%
%%%%                   %%%%
%%%%                   %%%%
%%%%                   %%%%
%%%%     .....         %%%%
%%%%     .....         %%%%
%%%%                   %%%%
%%%%                   %%%%
%%%%                   %%%%
%%%%                   %%%%
%%%%    .....          %%%%
%%%%   .......         %%%%
%%%%    .....          %%%%
%%%%%%%%%%%%%%%%%%%%%%%%%%%
%%%%%%%%%%%%%%%%%%%%%%%%%%%
#
%%%%%%%%%%%%%%%%%%%%%%%%%%%
%%%%%%%%%%%%%%%%%%%%%%%%%%%
%%%%%%%%%%%%%%%%%%%%%%%% %%
%%%%P     %%%%%%%%%%%%%%%%%
%%%%%%%%%%%%%%%%%%%%%%%%%%%
%%%%%%%%%%%%%%%%%%%% %%%%%%
%%%%%%%%%%%%%%%%%%%%  %%%%%
%%%%%%%%%%%%%   %%%%% %%%%%
%%               %%%% %%%%%
%%               %%%%% %%%%
%%  %%%%%%%%%%%%%%%%%% %%%%
%%  %%%%%%%%%%%%%%%%%% %%%%
%%  %%%%%%%%%%%%%%%%%%  %%%
%%  %%%%%%%%%%%%%%%%%% %%%%
%%       %%%%%%%%%%%%%%%%%%
%%      %%%%%%%%%%%%%%%%%%%
%%     %%%%%%%%%%%%%%%%%%%%
%%    %%%%%%%%%      %%% %%
%%   %%%%%.%%%%      %%% %%
%%  %%%%%%%%%%%%%%%%%%%% %%
%%%%%%%%%%%%%%%%%%%%%%%%%%%
%%%%%%%%%%%%%%%%%%%%%%%%%%%
#
%%%%%%%%%%%%%%%%%%%%%%%%%%%
%%%%%%%%%%%%%%%%%%%%%%%%%%%
%%%%%%%%%%%%%%%%%%%%%%%%%%%
%%%%%%%%%%%%%%%%%%%%%%%%%%%
%%%%%%%%%%%%             %%
%%%%%%%%%%%%             %%
%%%%%%%%%%%%             %%
%%%%%%%%%%%%             %%
%%%%%%%%%%%%             %%
%%         .             %%
%%         .             %%
%%         .             %%
%%         .             %%
%%         .             %%
%%         .             %%
%%        .              %%
%%       ...             %%
%%       ...             %%
%%%%%%%%%%%%%%%%%%%%%%%%%%%
%%%%%%%%%%%%%%%%%%%%%%%%%%%
%%%%%%%%%%%%%%%%%%%%%%%%%%%
%%%%%%%%%%%%%%%%%%%%%%%%%%%
#
