%%%%%%%%%%%%%%%%%%%%%%%
%%%%%%%%%%%%%%%%%%%%%%%
%%%%               %%%%
%%%%    .......    %%%%
%%%%    .......    %%%%
%%%%    .......    %%%%
%%%%               %%%%
%%%%               %%%%
%%%%               %%%%
%%%%               %%%%
%%%%               %%%%
%%%%               %%%%
%%%%               %%%%
%%%%               %%%%
%%%%               %%%%
%%%%               %%%%
%%%%               %%%%
%%%%               %%%%
%%%%               %%%%
%%%%%%%%%%%%%%%%%%%%%%%
%%%%%%%%%%%%%%%%%%%%%%%
#
%%%%%%%%%%%%%%%%%%%%%%%
%%%%%%%%%%%%%%%%%%%%%%%
%%      %%%%%%%%%%%%%%%
%%      %%%%%%%%    %%%
%%      %%%%%%%     %%%
%%      %%%%%%%%    %%%
%%      %%%%%%%%%%%%%%%
%%      %%%%%%%%%%%%%%%
%%%%%%%%%%%%%%%%%%%%%%%
%%%%%%%%%%%%%%%%%%% %%%
%%%%%%%%%%%%%%%%%%  %%%
%%        %%%%%%%   %%%
%% P         %%%    %%%
%%        %%%%%%%%%%%%%
%%%%%%%%%%%%%%%%%%%%%%%
%%%%%%%%%%%%%%%%%%%%%%%
%%%%%%%%%%%%%%%      %%
%%                   %%
%%                   %%
%%%%%%%%%%%%%%%%%%%%%%%
%%%%%%%%%%%%%%%%%%%%%%%
#
%%%%%%%%%%%%%%%%%%%%%%%
%%%%%%%%%%%%%%%%%%%%%%%
%%%%%%%%%%%%%%%%%%%%%%%
%%%%%%%%%%%%%%%%%%%%%%%
%%        ...    %%  %%
%%        ...   %%%  %%
%%%%%%%%%%%..  %%%%  %%
%%%%%%%%%%%%%%%%%%%  %%
%%%%%%%%%%%%%%%%%%%  %%
%%%%%%%%%%%%%%%%%%%  %%
%%%%%%%%%%%%%%%%%%%  %%
%%%%%%%%%%%%%%%%%%%%%%%
%%%%%%%%%%%%%%%%%%%%%%%
%%%%%%%%%%%%%%%%%%%%%%%
%%%%%%%%%%%%%%%%%%%%%%%
%%%%%%%%%%%%%%%%%%%%%%%
%%%%%%%%%%%%%%%%%%%%%%%
%%%%%%%%%%%%%%%%%%%%%%%
%%%%%%%%%%%%%%%%%%%%%%%
%%%%%%%%%%%%%%%%%%%%%%%
%%%%%%%%%%%%%%%%%%%%%%%
#
