%%%%%%%%%%%%%%%%%%%%%%%%%%%%%%%%%%%%%%%%%%%%%%
%%%%%%%%%%%%%%%%%%%%%%%%%%%%%%%%%%%%%%%%%%%%%%
%%%%                                      %%%%
%%%%                                      %%%%
%%%%                                      %%%%
%%%%                                      %%%%
%%%%                                      %%%%
%%%%                                      %%%%
%%%%                                      %%%%
%%%%                                      %%%%
%%%%                                      %%%%
%%%%                                      %%%%
%%%%                                      %%%%
%%%%                                      %%%%
%%%%      ........                   .....%%%%
%%%%       .......                   .....%%%%
%%%%                                 .....%%%%
%%%%                                      %%%%
%%%%                                      %%%%
%%%%                                      %%%%
%%%%                                      %%%%
%%%%                                      %%%%
%%%%                                      %%%%
%%%%  .......                             %%%%
%%%% ........                             %%%%
%%%%  ......                              %%%%
%%%%                                      %%%%
%%%%                                      %%%%
%%%%                                      %%%%
%%%%                                      %%%%
%%%%                         ......       %%%%
%%%%                        ........      %%%%
%%%%                        .......       %%%%
%%%%%%%%%%%%%%%%%%%%%%%%%%%%%%%%%%%%%%%%%%%%%%
#
%%%%%%%%%%%%%%%%%%%%%%%%%%%%%%%%%%%%%%%%%%%%%%
%%%%%%%%%%%%%%%%%%%%%%%%%%%%%%%%%%%%%%%%%%%%%%
%%%%%%%%%%%%%%%%%%%%%%%%%%%%%%%%%%%%%%%%%%%%%%
%%%%%%%%%%%%%%%%%%%%%%%%%%%%%%             %%%
%%%%%        %%%%%%%%%%%%%%%%%%            %%%
%%%%%P        %%%%%%%%%%%%%%%%%            %%%
%%%%%          %%%%%%%%%%%%%%%%%           %%%
%%%%%        %%%%%%%%%%%   %%%%%           %%%
%%%%%%%%%%%%%%%%%%%%%%%%    %%%%%          %%%
%%%%%%%%%%%%%%%%%%%%%%%%%   %%%%%          %%%
%%%%%%%%%%%%%%%%%%%%%%%%%    %%%%%         %%%
%%%%%%%%%%%%%%%%%%%%%%%%%    %%%%%         %%%
%%%%%%%%%%%%%%%%%%%%%%%%%     %%%%%%%%%%%%%%%%
%%%   %%%%%%%%%%%%%%%%%%%%%   %%%%%%%%%%%%%%%%
%%%  %%%%%%%%%%%%%%%%%%%%%%%   %%%%%%%%%%%%%%%
%%% %%%%%%%%%%%%%%%%%%%%%%%%  %%%%%%%%%%%%%%%%
%%%  %%%%%%%%%%%%%%%%%%%%%%% %%%%%%%%%%%%%%%%%
%%%   %%%%%%%%%%%%%%%%%%%%%% %%%%%%%%%%%%%%%%%
%%%        %%%%%%%%%%%%%%%%% %%%%%%%%%%%%%%%%%
%%%       %%%%%%%%%%%%%%%%%%%%%%%          %%%
%%%      %%%%%%%%%%%%%%%%%% %%%%%          %%%
%%%     %%%%%%%%%%%%%%%%%%  %%%%%          %%%
%%%    %%%%%%               %%%%%          %%%
%%%   %%%%%%%%%%%%%%%%%%%%% %%%%%          %%%
%%%  %%%%%%%%%%%%%%%%%%%%%%%%%%%%          %%%
%%% %%%%%%%%%%%%%%%%%%%%%%%%%%%%%          %%%
%%%  %%%%%%%%%%%%%%%%%%%%%%%%%%%%%%%%%%%   %%%
%%%   %%%%%%%%%%%%%%%%%%%%%%%%%%%%%%%%%%   %%%
%%%                    %%%%%%%%%%%%%%%%%   %%%
%%%                    %%%%% %%%%%%%%%%%   %%%
%%%                    %%%%%  ....  %%%%   %%%
%%%                    %%%%%%%%%%%%%%%%%   %%%
%%%%%%%%%%%%%%%%%%%%%%%%%%%%%%%%%%%%%%%%%%%%%%
%%%%%%%%%%%%%%%%%%%%%%%%%%%%%%%%%%%%%%%%%%%%%%
#
%%%%%%%%%%%%%%%%%%%%%%%%%%%%%%%%%%%%%%%%%%%%%%
%%%%%%%%%%%%%%%%%%%%%%%%%%%%%%%%%%%%%%%%%%%%%%
%%%%%%%%%%%%%%%%%%%%%%%%%%%%%%%%%%%%%%%%%%%%%%
%%%%%%%%%%%%%%%%%%%%%%%%%%%%%%%%%%%%%%%%%%%%%%
%%%%%%%%%%%%%%                              %%
%%%%%%%%%%%%%%                              %%
%%                                          %%
%%%%%%%%%%%%%%                              %%
%%%%%%%%%%%%%%                              %%
%%%%%%%%%%%%%%                              %%
%%%%%%%%%%%%%%                              %%
%%%%%%%%%%%%%%.                             %%
%%%%%%%%%%%%%%..                       ...  %%
%%%%%%%%%%%%%%..                       ...  %%
%%           ...                       ...  %%
%%           ...                       ...  %%
%%           ...                       ...  %%
%%           ...                       ...  %%
%%            .                        ...  %%
%%                                          %%
%%       .                                  %%
%%      ...                                 %%
%%      ...                                 %%
%%      ...                                 %%
%%      ...                                 %%
%%      ...                                 %%
%%      ...                                 %%
%%      ..                                  %%
%%                             ..           %%
%%                            ...           %%
%%%%%%%%%%%%%%%%%%%%%%%%%%%%%%%%%%%%%%%%%%%%%%
%%%%%%%%%%%%%%%%%%%%%%%%%%%%%%%%%%%%%%%%%%%%%%
%%%%%%%%%%%%%%%%%%%%%%%%%%%%%%%%%%%%%%%%%%%%%%
%%%%%%%%%%%%%%%%%%%%%%%%%%%%%%%%%%%%%%%%%%%%%%
#
