%%%%%%%%%%%%%%%%%%%%%%%%%%%%%%%%%%%%%
%%%%%%%%%%%%%%%%%%%%%%%%%%%%%%%%%%%%%
%%%%                             %%%%
%%%%                             %%%%
%%%%                             %%%%
%%%%                             %%%%
%%%%                             %%%%
%%%%                             %%%%
%%%%                             %%%%
%%%%                             %%%%
%%%%                             %%%%
%%%%     .....                ...%%%%
%%%%     .....               ....%%%%
%%%%                          ...%%%%
%%%%                             %%%%
%%%%                             %%%%
%%%%                             %%%%
%%%%                             %%%%
%%%% .....                       %%%%
%%%%.......                      %%%%
%%%% .....                       %%%%
%%%%                             %%%%
%%%%                             %%%%
%%%%                             %%%%
%%%%                   .....     %%%%
%%%%                  .......    %%%%
%%%%%%%%%%%%%%%%%%%%%%%%%%%%%%%%%%%%%
%%%%%%%%%%%%%%%%%%%%%%%%%%%%%%%%%%%%%
#
%%%%%%%%%%%%%%%%%%%%%%%%%%%%%%%%%%%%%
%%%%%%%%%%%%%%%%%%%%%%%%%%%%%%%%%%%%%
%%%%%%%%%%%%%%%%%%%%%%%%           %%
%%%%      %%%%%%%%%%%%%%%          %%
%%%%P      %%%%%%%%%%%%%%          %%
%%%%       %%%%%%%%  %%%%%         %%
%%%%      %%%%%%%%%   %%%%         %%
%%%%%%%%%%%%%%%%%%%%  %%%%%        %%
%%%%%%%%%%%%%%%%%%%%   %%%%        %%
%%%%%%%%%%%%%%%%%%%%   %%%%%       %%
%%   %%%%%%%%%%%%%%%    %%%%%%%%%%%%%
%%  %%%%%%%%%%%%%%%%%%  %%%%%%%%%%%%%
%%  %%%%%%%%%%%%%%%%%%  %%%%%%%%%%%%%
%%  %%%%%%%%%%%%%%%%%% %%%%%%%%%%%%%%
%%       %%%%%%%%%%%%% %%%%%%%%%%%%%%
%%      %%%%%%%%%%%%%% %%%%        %%
%%     %%%%%%%%%%%%%%% %%%%        %%
%%    %%%%%            %%%         %%
%%   %%%%%             %%%         %%
%%  %%%%%%%%%%%%%%%%%% %%%         %%
%%  %%%%%%%%%%%%%%%%%% %%%         %%
%%  %%%%%%%%%%%%%%%%%% %%%%%%%%%   %%
%%                 %%% %%%%%%%%%   %%
%%                 %%% %%%%%%%%%   %%
%%                 %%%  ...  %%%   %%
%%                 %%%%%%%%%%%%%   %%
%%%%%%%%%%%%%%%%%%%%%%%%%%%%%%%%%%%%%
%%%%%%%%%%%%%%%%%%%%%%%%%%%%%%%%%%%%%
#
%%%%%%%%%%%%%%%%%%%%%%%%%%%%%%%%%%%%%
%%%%%%%%%%%%%%%%%%%%%%%%%%%%%%%%%%%%%
%%%%%%%%%%%%%%%%%%%%%%%%%%%%%%%%%%%%%
%%%%%%%%%%%%%%%%%%%%%%%%%%%%%%%%%%%%%
%%%%%%%%%%%                        %%
%%%%%%%%%%%                        %%
%%%%%%%%%%%%                       %%
%%%%%%%%%%%%                       %%
%%%%%%%%%%%%                       %%
%%%%%%%%%%%%                    .  %%
%%%%%%%%%%%%.                  ... %%
%%%%%%%%%%%..                  ... %%
%%        ...                  ... %%
%%        ...                  ... %%
%%         .                   ... %%
%%                              .  %%
%%     .                           %%
%%    ...                          %%
%%    ...                          %%
%%    ...                          %%
%%    ...                          %%
%%    ...                          %%
%%     .                 .         %%
%%                      ...        %%
%%%%%%%%%%%%%%%%%%%%%%%%%%%%%%%%%%%%%
%%%%%%%%%%%%%%%%%%%%%%%%%%%%%%%%%%%%%
%%%%%%%%%%%%%%%%%%%%%%%%%%%%%%%%%%%%%
%%%%%%%%%%%%%%%%%%%%%%%%%%%%%%%%%%%%%
#
