%%%%%%%%%%%%%%
%%%%%%%%%%%%%%
%%%%      %%%%
%%%%      %%%%
%%%%  ....%%%%
%%%%  ....%%%%
%%%%  ....%%%%
%%%%      %%%%
%%%%      %%%%
%%%%      %%%%
%%%%%%%%%%%%%%
#
%%%%%%%%%%%%%%
%%%%%%%%%%%%%%
%%%%%%%%%%%%%%
%%%P     ..%%%
%%%     ...%%%
%%%     ...%%%
%%%     ...%%%
%%%      ..%%%
%%%%%%%%%%%%%%
%%%%%%%%%%%%%%
%%%%%%%%%%%%%%
#
%%%%%%%%%%%%%%
%%%%%%%%%%%%%%
%%%%%%%%%%%%%%
%%%%%%%%%%%%%%
%%%%%%%%%%%%%%
%%       ... %
%%       ... %
%%%%%%%%%%%%%%
%%%%%%%%%%%%%%
%%%%%%%%%%%%%%
%%%%%%%%%%%%%%
#
