%%%%%%%%%%%%%%%%%%%%%%%%%%%%%%%%
%%%%%%%%%%%%%%%%%%%%%%%%%%%%%%%%
%%%%                        %%%%
%%%%                        %%%%
%%%%                        %%%%
%%%%                        %%%%
%%%%                        %%%%
%%%%                        %%%%
%%%%                        %%%%
%%%%                        %%%%
%%%%                        %%%%
%%%%     .....              %%%%
%%%%     .....              %%%%
%%%%                        %%%%
%%%%                        %%%%
%%%%                        %%%%
%%%%                        %%%%
%%%%                        %%%%
%%%% .....                  %%%%
%%%%.......                 %%%%
%%%% .....                  %%%%
%%%%                        %%%%
%%%%                        %%%%
%%%%                        %%%%
%%%%                   .....%%%%
%%%%                  ......%%%%
%%%%                   .....%%%%
%%%%                        %%%%
%%%%                        %%%%
%%%%%%%%%%%%%%%%%%%%%%%%%%%%%%%%
%%%%%%%%%%%%%%%%%%%%%%%%%%%%%%%%
#
%%%%%%%%%%%%%%%%%%%%%%%%%%%%%%%%
%%%%%%%%%%%%%%%%%%%%%%%%%%%%%%%%
%%%%%%%%%%%%%%%%%%%%%%%%%     %%
%%%%      %%%%%%%%%%%%%%%     %%
%%%%P      %%%%%%%%  %%%%%    %%
%%%%      %%%%%%%%%   %%%%    %%
%%%%%%%%%%%%%%%%%%%%  %%%%    %%
%%%%%%%%%%%%%%%%%%%%%  %%%%   %%
%%%%%%%%%%%%     %%%%  %%%%   %%
%%               %%%%% %%%%%  %%
%%  %%%%%%%%%%%%%%%%%%  %%%%  %%
%%  %%%%%%%%%%%%%%%%%%  %%%%  %%
%%  %%%%%%%%%%%%%%%%%%   %%%  %%
%%  %%%%%%%%%%%%%%%%%%  %%%%  %%
%%       %%%%%%%%%%%%% %%%%%  %%
%%      %%%%%%%%%%%%%%%%%%%   %%
%%     %%%%%%%%%%%%%%%%%%%%   %%
%%    %%%%%%          %%%%    %%
%%   %%%%%%%          %%%%    %%
%%  %%%%%%%%%%%%%%%%%%%%%%    %%
%%  %%%%%%%%%%%%%%%%%%%%%%    %%
%%  %%%%%%%%%%%%%%%%%%%%%%%%%%%%
%%                 %%%%%%%%%%%%%
%%                 %%%%%%%%%%%%%
%%                 %%%  ...  %%%
%%                 %%%  ...  %%%
%%                 %%%  ...  %%%
%%                 %%%%%%%%%%%%%
%%                 %%%%%%%%%%%%%
%%%%%%%%%%%%%%%%%%%%%%%%%%%%%%%%
%%%%%%%%%%%%%%%%%%%%%%%%%%%%%%%%
#
%%%%%%%%%%%%%%%%%%%%%%%%%%%%%%%%
%%%%%%%%%%%%%%%%%%%%%%%%%%%%%%%%
%%%%%%%%%%%%%%%%%%%%%%%%%%%%%%%%
%%%%%%%%%%%%%%%%%%%%%%%%%%%%%%%%
%%%%%%%%%%%                   %%
%%%%%%%%%%%%                  %%
%%%%%%%%%%%%                  %%
%%%%%%%%%%%%                  %%
%%%%%%%%%%%%                  %%
%%%%%%%%%%%%                  %%
%%%%%%%%%%%.                  %%
%%         .                  %%
%%         .                  %%
%%         .                  %%
%%         .                  %%
%%                            %%
%%     .                      %%
%%    ...                     %%
%%    ...                     %%
%%    ...                     %%
%%    ...                     %%
%%    ...                     %%
%%     .                 .    %%
%%                      ...   %%
%%                      ...   %%
%%                      ...   %%
%%                      ...   %%
%%%%%%%%%%%%%%%%%%%%%%%%%%%%%%%%
%%%%%%%%%%%%%%%%%%%%%%%%%%%%%%%%
%%%%%%%%%%%%%%%%%%%%%%%%%%%%%%%%
%%%%%%%%%%%%%%%%%%%%%%%%%%%%%%%%
#
