%%%%%%%%%%%%
%%%%%%%%%%%%
%%%%    %%%%
%%%% ...%%%%
%%%% ...%%%%
%%%% ...%%%%
%%%%    %%%%
%%%%    %%%%
%%%%%%%%%%%%
#
%%%%%%%%%%%%
%%%%%%%%%%%%
%%%%%%%%%%%%
%%%P  ...%%%
%%%   ...%%%
%%%   ...%%%
%%%    ..%%%
%%%%%%%%%%%%
%%%%%%%%%%%%
#
%%%%%%%%%%%%
%%%%%%%%%%%%
%%%%%%%%%%%%
%%%%%%%%%%%%
%%     ...%%
%%%%%%%%%%%%
%%%%%%%%%%%%
%%%%%%%%%%%%
%%%%%%%%%%%%
#
